method,type,bytes,num_fields,prep_time,copy_time,alloc_time,dealloc_time,write_time,total_time
SG,0,1024,2,1695,0,0,0,9920,11615
SG,0,1024,2,874,0,0,0,1319,2193
SG,0,1024,2,777,0,0,0,2483,3260
SG,0,1024,2,759,0,0,0,592,1351
SG,0,1024,2,782,0,0,0,639,1421
SG,0,1024,2,774,0,0,0,648,1422
SG,0,1024,2,736,0,0,0,5456,6192
SG,0,1024,2,741,0,0,0,626,1367
SG,0,1024,2,739,0,0,0,558,1297
SG,0,1024,2,723,0,0,0,587,1310
