method,type,bytes,num_fields,prep_time,copy_time,alloc_time,dealloc_time,write_time,total_time
SG,0,8,2,2780,0,0,0,10810,13590
SG,0,8,2,820,0,0,0,3586,4406
SG,0,8,2,661,0,0,0,2345,3006
SG,0,8,2,639,0,0,0,2450,3089
SG,0,8,2,625,0,0,0,2395,3020
SG,0,8,2,676,0,0,0,2522,3198
SG,0,8,2,650,0,0,0,2375,3025
SG,0,8,2,628,0,0,0,2307,2935
SG,0,8,2,708,0,0,0,2333,3041
SG,0,8,2,640,0,0,0,2305,2945
