method,type,bytes,num_fields,prep_time,copy_time,alloc_time,dealloc_time,write_time,total_time
SG,0,3471,420,2124,0,0,0,10805,12929
SG,0,3471,420,1097,0,0,0,2897,3994
SG,0,3471,420,1173,0,0,0,3823,4996
SG,0,3471,420,1063,0,0,0,3681,4744
SG,0,3471,420,992,0,0,0,1795,2787
SG,0,3471,420,1108,0,0,0,3203,4311
SG,0,3471,420,995,0,0,0,1690,2685
SG,0,3471,420,1079,0,0,0,2102,3181
SG,0,3471,420,931,0,0,0,4267,5198
SG,0,3471,420,977,0,0,0,1727,2704
