method,type,bytes,num_fields,prep_time,copy_time,alloc_time,dealloc_time,write_time,total_time
SG,0,3471,420,2190,0,0,0,11554,13744
SG,0,3471,420,1433,0,0,0,2668,4101
SG,0,3471,420,1264,0,0,0,4069,5333
SG,0,3471,420,1179,0,0,0,3593,4772
SG,0,3471,420,1208,0,0,0,1777,2985
SG,0,3471,420,1252,0,0,0,3003,4255
SG,0,3471,420,1264,0,0,0,1774,3038
SG,0,3471,420,1264,0,0,0,3008,4272
SG,0,3471,420,1320,0,0,0,4898,6218
SG,0,3471,420,1296,0,0,0,1778,3074
