method,type,bytes,num_fields,prep_time,copy_time,alloc_time,dealloc_time,write_time,total_time
SG,0,3471,420,1941,0,0,0,9012,10953
SG,0,3471,420,1059,0,0,0,1336,2395
SG,0,3471,420,896,0,0,0,3005,3901
SG,0,3471,420,874,0,0,0,499,1373
SG,0,3471,420,878,0,0,0,611,1489
SG,0,3471,420,892,0,0,0,502,1394
SG,0,3471,420,876,0,0,0,2592,3468
SG,0,3471,420,859,0,0,0,536,1395
SG,0,3471,420,815,0,0,0,644,1459
SG,0,3471,420,868,0,0,0,491,1359
