method,type,bytes,num_fields,prep_time,copy_time,alloc_time,dealloc_time,write_time,total_time
ZC,0,11,11,2930,0,0,0,11689,14619
ZC,0,11,11,632,0,0,0,3556,4188
ZC,0,11,11,497,0,0,0,2376,2873
ZC,0,11,11,522,0,0,0,2469,2991
ZC,0,11,11,484,0,0,0,2320,2804
ZC,0,11,11,494,0,0,0,2502,2996
ZC,0,11,11,485,0,0,0,2329,2814
ZC,0,11,11,496,0,0,0,2332,2828
ZC,0,11,11,524,0,0,0,2295,2819
ZC,0,11,11,489,0,0,0,2322,2811
